    SO ./path_to_the_south_texture
        NO ./path_to_the_north_texture
 WE ./path_to_the_west_texture
EA ./path_to_the_east_texture



                         
F 220,100,0
C 225,30,0

1111111111111111111
1000000000111000001
1011010001110111111
1001000S01111000001
1000000000110000011
1111111110000000011
1111011111101101011
1111011111111101111
1100011001101010011
1111111111111111111
