    SO ./path_to_the_south_texture
        NO ./path_to_the_north_texture
 WE ./path_to_the_west_texture
EA ./path_to_the_east_texture



                         
F 220,100,0
C 225,30,0

111111111111111111111111
100000000011100000000001
101101000111011111000001
100101000111100000000001
100000100011000001110111
111111111011100001110001
111101111111N10101000001
111101111111110111010101
110001100110101001101001
100000110110000010001001
100000111110000011010101
110110011101010000000111
11111111 111010000001111
111111111111111111111111